111111
1C00M1
110001
1CEMP1
111111