1111111111111
1000000011111
1000C0C000111
1P0C0C0C000E1
1111111111111