111111
1C0001
110001
1E00P1
111111