111111
1CM0M1
110001
1CE0P1
111111