111111
1C00P1
110001
1E0001
111111