111111111111111111111111111111
100M000M0000000M00000000000001
100C001111000M000M000001M1C101
100000000000000000000001M1C101
100000001111100000000001M1C101
10000C00000000111111M001M1C101
1P00M00000000C0000000001M1C1E1
111111111111111111111111111111