111111111111111111111111111111
10000000000000000000000000C001
100C001111000000000000000000E1
100000000000000000000000000001
100000001111100000000000000001
10000C000000000000000000000001
1P00000000000C0000000000000001
111111111111111111111111111111