1111111111111111111111111
10010000000C1000000111111
1P0001111100100000000C001
1000000000010000000000001
10C00C000C0000000000000E1
1111111111111111111111111