1111111111111
10000000000C1
1110011111111
1P00000000E01
1111111111111