1111111111111
10010000000C1
1000011111111
1P00000000EC1
1111111111111