1111111111111
1C000000000C1
1110011111111
1P00000010E01
1111111111111