11111111111111111111111111111111111111111111111111111111111111111111111111111111111111111111111111111111
1C010000000111000001111110000000000000000000000000000000000000000000000000000000000000000000000000001111
100001111100100000000000110000111110010M0000000001100001111100100000000000110000111110010000000000011001
1P00000000E1000000000000110000111110010000M000M001100001111100100000000000100000000000000000000000011111
10C0C0C0C00000000000000000000000000000000000000000000000000000000000000000000000000000000000000000000001
100C0C0C000000000000000000000000000000000000000000111000000000000000000000000000000000000000000000000001
1000C0C0000000000000001111111111111111111111000000000000000000000000000000000000000000000000000000000001
10000C00000000000000000000000000000000000000000000000000000000000000000000000000000000000000000000000001
1M0M0M0M0M0M0M0000000000000000000MMMMMMMMMMMMMMMMMMMMMMMMMMM00000000000000000000000000000000000000MMMMM1
11111111111111111111111111111111111111111111111111111111111111111111111111111111111111111111111111111111